7,11,2,14,3,14,3,2,2,6
5,11,0,2,8,2,4,13,13,5
1,10,12,13,11,12,9,2,14,5
13,11,6,3,2,10,10,0,14,5
3,10,8,4,13,3,10,0,14,5
13,11,10,4,3,12,11,0,14,5
11,10,2,4,5,7,7,1,6,13
3,2,4,13,13,1,0,4,9,6
13,5,13,11,10,12,5,5,11,4
11,12,11,10,10,10,12,13,11,12
