3,2,10,14,3,10,10,6,11,6
5,5,11,10,12,3,14,9,10,4
5,9,6,3,10,8,10,10,10,12
5,3,4,9,6,3,2,10,10,14
5,5,5,3,12,5,13,3,10,6
5,5,5,5,7,1,6,5,3,4
5,5,13,5,9,12,5,5,5,5
5,9,6,9,6,3,12,5,5,5
5,7,9,6,5,9,10,12,5,5
9,8,14,9,8,10,10,10,12,13
