7,11,2,2,6,7,3,14,7,7
9,10,4,13,13,9,0,10,0,4
3,14,1,2,14,11,0,14,13,13
1,2,12,13,11,2,12,7,7,7
5,1,14,7,3,8,10,8,8,4
5,13,7,1,12,3,10,14,11,12
5,7,1,8,2,8,2,14,7,7
9,8,4,7,13,7,13,7,1,12
11,6,1,8,10,0,2,0,8,14
11,8,8,10,14,13,13,9,10,14
