7,11,2,10,10,10,6,3,14,7
5,7,13,7,7,11,0,4,3,12
1,12,7,9,4,7,13,5,1,14
1,14,1,6,1,4,7,5,5,7
1,14,13,5,13,9,0,8,8,12
9,10,6,9,10,2,8,2,10,14
7,3,4,7,11,12,7,1,10,14
9,4,13,9,10,2,8,0,2,14
3,0,10,6,11,4,11,12,1,14
13,13,11,8,10,8,10,14,9,14
