7,3,10,14,3,2,10,14,11,6
5,1,14,11,4,9,6,11,10,4
1,0,2,14,13,11,0,14,3,12
5,13,9,2,10,10,4,7,5,7
9,14,11,12,3,10,8,0,8,12
11,6,11,10,12,7,11,4,3,14
11,0,10,10,6,1,2,0,0,14
11,12,11,2,0,4,5,13,9,6
11,10,2,4,13,5,1,2,6,5
11,10,12,13,11,12,13,13,13,13
