3,14,3,10,10,10,10,2,10,6
5,3,12,11,6,3,6,13,3,4
5,9,2,10,12,5,9,6,5,13
1,14,5,3,6,9,6,5,9,6
9,10,12,5,9,10,12,5,3,12
3,10,6,5,7,3,10,12,9,6
5,11,8,12,5,5,3,6,3,12
5,7,3,10,4,5,5,5,9,6
5,5,9,6,5,9,12,9,6,5
9,12,11,12,9,10,10,10,8,12
